######################################
|                                    |
|                                    |
|             #######                |                   #####
|                                    |
|                                    |
|                                    |
|                                    |
|                                    |
|                                    |               
|                    ##              |
|                    ##              |
|                    ##              |                       #####
|                                    |
|                                    |
|                                    |
######################################
